1111111111111111111111111111111111
1010010010101010001000000000010101
100000000C00C00010000E0000000000C1
101001P010101010001000000000010101
100000000C00C0000000000000000000C1
1111111111111111111111111111111111
